####################
#         O        #
#                  #
#     P            #
####               #
####      ##########
###   #   ##########
#     #   X        #
#     #            #
#O    #            #
#######        #####
# X                #
#                  #
#       ###        #
#       ###     X  #
#       ###        #
#O      ###        #
####################
